11111111111
1P000000001
10000000C01
10010001001
10010E01001
10010001001
10000000001
1C000C00001
11111111111
