11111111111
1P0V000V001
10000000C01
10010H01001
10010E01001
10010H01001
10000000001
1C0V0C0V001
11111111111
